Utførelse
  $ source script (ett skall)
  $ ./script (skall, subskall/-prosess)
  $ ./script & (skall, subskall/-prosess)
  Funksjon: ett skall
  Builtin
  Cmd|script hash
  Cmd|script $PATH

Environment
  $ env

Exceution environment
  Alias': bash (alias)
  Params: bash/cmd hvis eksport
  Funksjoner: bash/cmd hvis eksport
  Opsjoner: bash (set shopt)
  PIDs: bash $$, $PPID mfl (ps)
  Arbeidskatalog: bash/cmd (pwd)
  Filopprettelsesmaske: bash/cmd (umask)
  Åpene filer: bash/cmd (lsof)
  Traps: bash/cmd (trap)
  
Signaler
  sighup: exit (1)
  sigint: håndteres (2)
  sigquit: ignoreres (3)
  sigkill: exit (9)
  sigterm: ignoreres (15)
  sigtstp: ignoreres (20)
  ...

Fullførelse
  Lagrer exit code i $?
