Vars: awkdv
    ARGC: 1
    ARGIND: 0
    ARGV: array, 1 elements
    BINMODE: 0
    CONVFMT: "%.6g"
    ENVIRON: array, 83 elements
    ERRNO: ""
  FIELDWIDTHS for fixed-width data: ""
  FILENAME    file name: ""
  FNR         file number of records: 0
  FPAT        field pattern: "[^[:space:]]+"
  FS          field separator: "", " ", "char", "regexp"
    FUNCTAB: array, 41 elements
  IGNORECASE  for regexp: 0|1...
    LINT: 0
  NF          number of fields: 0 
  NR          number of records: 0
  OFMT        output format string: "%.6g"
  OFS         output field separator: " " 
  ORS         output record separator: "\n"
    PREC: 53
    PROCINFO: array, 25 elements
    RLENGTH: 0
    ROUNDMODE: "N"
  RS          record separator: "", "\n", "char", "regexp"
    RSTART: 0
  RT          record text that matched RS: ""
    SUBSEP: "\034"
    SYMTAB: array, 28 elements
    TEXTDOMAIN: "messages"
